........................#########..............
........................#.......#..............
........................#.......#..............
........................#.......#..............
........................#.......#..............
........................#.......#..............
........................#.......#..............
........................#.......#..............
........................#.......#..............
................................#..............
................................#..............
................................#..............
................................#########......
........................................#......
............#########...................#......
............#.......#...................#......
............#.......#...................#......
............#.......#...................#......
............#.......#...................#......
............#.......#...................#......
........#########...#.......#############......
........#...#...#...#.......#..................
#############...#...#.......#..................
#.......#.......#...#.......#..................
#.......#.......#...#.......#..................
#.......#.......#...#.......#..................
#.......#.......#...#############..............
#.......#.......#...........#...#..............
#.......#.......#.........############^........
#.......#.......#.........#.#...#..............
#########.......#.........#.#...#..............
................#.........#.#...#..............
................#############...#..............
..........................#.....#..............
..........................#.....#..............
..........................#.....#..............
..........................#.....#..............
..........................#.....#..............
....................#############..............
....................#.....#....................
..............#############....................
..............#.....#..........................
..............#.....#..........................
..............#.....#..........................
..............#.....#..........................
..............#.....#..........................
..............#.....###########................
..............#...............#................
..............#...............#.......#########
..............#...............#.......#.......#
..............#...............#.......#.......#
..............#...............#.......#.......#
..............#############...#.......#.......#
..........................#...#.......#.......#
..........................#...#.......#.......#
..........................#...#.......#.......#
..........................#...#...#############
..........................#...#...#...#........
..........................#...#########........
..........................#.......#............
..........................#.......#............
..........................#.......#............
..........................#.......#............
..........................#.......#............
..........................#########............

